Transaction Date,Value Date,Description,Reference,Debit,Credit,Balance
15-Jan-2025,15-Jan-2025,RENT PMT DUBAI PROPERTIES LLC,CHQ-001234,5000.00,,95000.00
18-Jan-2025,18-Jan-2025,DEWA - ELECTRICITY BILL,DD-DEWA-8765,,1200.00,93800.00
20-Jan-2025,20-Jan-2025,SALARY TRANSFER - EMPLOYEES,TRF-SAL-001,25000.00,,68800.00
22-Jan-2025,22-Jan-2025,GOOGLE WORKSPACE SUBSCRIPTION,CC-GOOGLE-456,2400.00,,66400.00
25-Jan-2025,25-Jan-2025,CLIENT PMT - ACME CORP,,15000.00,81400.00
28-Jan-2025,28-Jan-2025,FB ADS - MARKETING CAMPAIGN,CC-META-789,5000.00,,76400.00
30-Jan-2025,30-Jan-2025,OFFICE DEPOT - SUPPLIES,CC-DEPOT-321,850.00,,75550.00
31-Jan-2025,31-Jan-2025,EMIRATES NBD - BANK CHARGES,CHRG-JAN25,250.00,,75300.00
